20 10
####################
  ###              #
# ###              #
# ###              #
# ###              #
# ###              #
# ###              #
# ### ##############
#                   
####################
