10 10
##########
  #      #
# # ## # #
# # #  # #
# #    # #
# #  ### #
# #    # #
# #### # #
#      #  
##########
